########################################
#..*! *.........* !  *..........*      #
#..*  *.........*    *..........*      #
#..*  *.........*    *..........*      #
#..*  *.........*    *..........*      #
#***  *.........*    *..........*  S   #
#     *.........*    ************      #
#     ***********                      #
#                                      #
#           *****************          #
#           *...............*          #
#           *****************          #
#                                      #
#                  ******  **********  #
#     **********   *....*  *........*  #
#     *........*   *....*  *........*  #
#     *........*   *....*  *........*  #
#     *........*   *....*  *........*  #
#ඞ    *........* ! *....*! *........*! #
########################################